NO ./mursxpm/128_1.xpm
SO ./mursxpm/128_2.xpm
WE ./mursxpm/128_3.xpm 
EA ./mursxpm/128_4.xpm













F 123,156,189

C 169,233,0 

        11111111111111111111111111111111111111111111111111
        111111111111111111111111111111111111111111111S00011
        1000000000110000000000001                    1111
        1010000001110000000000001
        100100000000000000000011
11111111101100000111000000000001
10000000001100000111011111011111
11110111111111011100000010001
11110111111111011101010010001
11000000110101011100000010001
100000000000000011000000100011111
111111111111111111111111111111111
